 ---------------------------------> BOW AND ARROW <---------------------------- 
: SCORE: xxxxx                         LEVEL 1                                 :
: HIGH SCORE: xxxxx                    ARROWS                   ::::::::::::::: 
 ------------------------------------------------------------------------------ 
:                                                                              :
:                                                                              :
:                                                                              :
:                                                                              :
:                                                                              :
:                                                                              :
:                                                                              :
:                                                                              :
:                                                                              :
:                                                                              :
:                                                                              :
:                                                                              :
:                                                                              :
:                                                                              :
:                                                                              :
:                                                                              :
:                                                                              :
:                                                                              :
:                                                                              :
:                                                                              :
:                                                                              :
:                                                                              :
:                                                                              :
:                                                                              :
:                                                                              :
:                                                                              :
:                                                                              :
:                                                                              :
:                                                                              :
:                                                                              :
 ------------------------------------------------------------------------------ 